10111111100000000000000000000000000000000000000000
10000000100000000000000000000000000000000000000000
10000011101111111111101110000000111111111000000000
10000000101001000100111010000000100100001111111100
11100011111111001110000000001111100100000100000100
00110000100000011000000011111000000100000100000100
00010011111100001111111110001000000100011111000100
00010010000111111000000000001111111111110101111110
00010111111000000011011111111000100000000100010010
00010100000011100010010000000000111000001110010010
00011111111010100111110000000000001000001011110010
00000010000000101100000000000000001001101110100010
00000011110000111000000111100000100000100000111110
00000000010001100000000100111111100000100000000010
00000000010011000111111100100100111111111111111110
01111111110110001100000100100100100001000000001000
01010101010000001000000101100100100001111111111000
01010101011111111111000100001110100000000010001000
01010101000000000001111100001010100000000010001000
01010101000000000001000111001011100111100010001000
01010101001111111011000101000000100000100010001000
01010101001000001010000101111100100000111111100000
01010101000000001010000100100011110000010000101110
01010101001111111010000100101100011000010001101010
01010101011000000010001100101000001011010101001010
01010101010000000011111000111001001001010101011010
01010101011011111101001000000001001001110101010000
01010101001110000101001111100111001000010101010000
01010101000001111101001000100001001000010101010000
01010101001111000001001010111111001000010101010000
01010101011000000001111011100000001011110101010111
01010101010001111110000000100000001010001101010101
01010101011001000010000100100000001010111001011111
01010101001101000110011111111111111011100001110001
01010101000101000100010100000000000000000000000001
01010101000101000111010100000000111111100000111101
01010101000101100001010111110000100000111100100001
01010101000100100001010000010000111111100111111001
01010101000110100111111100011001010010100100001001
01010101000011100100010110001001010010100100001001
01010101000000100111110010011001110011100100000001
01010101000000100000000010010000000000000111111001
01010101011111111111110010010001110000001100001101
01010101010000000010010010011001011000001011100101
01010101011111111111010011001001000011111010111101
01010101000010010101111001011111000010101010000001
01010101000010010100101001110001111100001011111111
01010101000010011100101000100000000011111100000001
01010101000010000111111110100000000000000111111001
00000000000010000000000011100000000000000000000001
