0000000000000000000000000
0111111111111111110011111
0100010000000000010010001
0100011111111100011110001
0111010000000100010010001
0101111111100111111111101
0101000000100100010000101
0101111111111111110000101
0101000000100010011111111
0101000111100010000100100
0101000100000111000100100
0111111111111101110100100
0101000100000111010100100
0101000100000010010100100
0101001100111110011111110
0101111000100010000100010
0101001111111111000101110
0101001000100001111100010
0101111000100001000100110
0100001111111111111111100
0100001000000100000000100
0111111000000100011111100
0000001111100100010010000
0000000000111111111110000
0000000000000000000000000
